                                E
                                E
                                E
   MO      MO                   E
  MEF      DEO                  E
 MEEENN2225EEEO                 E
NEEEE222222EEEEO                E
EEEEE422222EEEEEO               E
EEEEE222222EEEEEEO              E
EEEEE2222NNEEEEEEEO             E
EEEEE222222EEEEEEEEO            E
EEEEE422225EEEEEEEEEO           E
EEEEE222222EEEEEEEEEEO          E
EEEEE222222EEEEEEEEEEEO         E
EEEEE22NN22EEEEEEEEEEEEO        E
EEEEE222222EEEEEEEEEHHHI        E
EEEEE422225EEEEEEEEF     MO     E
EEEEE222222EEEEEEEEF 8   DF     E
EEEEE222222EEEEEEEEEJKLBBEF     E
EEEEE22NN22EEEEEEEEEEEEEEEENNNNNE
EEEEE222222EEEEEEEEEEEEEEEEEEEEEE
EEEEE222225EEEEEEEEEEEEEEEEEEEEEE
EEEEE222222EEEEEEEEEEEEEEEEEEEEEE
EEEEE222222EEEEEEEEEEEEEEEEEEEEEE
EEEEENNNN22EEEEEEEEEEEEEEEEEEEEEE
EEEEE222222EEEEEEEEEEEEEEEEEEEEEE
EEEEE422222EEEEEEEEEEEEEEEEEEEEEE
EEEEE222222EEEEEEEEEEEEEEEEEEEEEE
EEEEE222222EEEEEEEEEEEEEEEEEEEEEE
EEEEE22NNNNEEEEEEEEEEEEEEEEEEEEEE
EEEEE222222EEEEEEEEEEEEEEEEEEEEEE
EEEEE222222EEEEEEEEEEEEEEEEEEEEEE
EEEEE222222EEEEEEEEEEEEEEEEEEEEEE
EEEEE222222EEEEEEEEEEEEEEEEEEEEEE
EEEEENO  MNEEEEEEEEEEEEEEEEEEEEEE
EEEEEEF  DEEEEEEEEEEEEEEEEEEEEEEE
EEEEEEF  DEEEEEEEEEEEEEEEEEEEEEEE
EEEEEEF  DEEEEEEEEEEEEEEEEEEEEEEE
EEEHHHI  GHHHEEEEEEEEEEEEEEEEEEEE
EEF          DEEEEEEEEEEEEEEEEEEE
EEF          GHHHHHHHHHHHHEEEEEEE
EEF                       DEEEEEE
EEF                       DEEEEEE
EEF                 MNNNO DEEEEEE
EEF                MEEEEF DEEEEEE
EEF                DEEEEF DEEEEEE
EEEO            MNNEEEEEF DEEEEEE
EEEF             GHEEEEEF DEEEEEE
EEF       MO       DEEEEF DEEEEEE
EEF      MEF  MO   DEEEEF DEEEEEE
EEF      DEF  DF   DEEEEF DEEEEEE
EEENNNNNNEEENNEENNNEEEEEF DEEEEEE
EEEHHHHHHHHHHHHHHHHHHHHHI GHHHEEE
EEF                           DEE
EEF                           DEE
EEF                           DEE
EEF                           DEE
EEF                           DEE
EEF  9                        DEE
EEF  N                        DEE
EEF MNO                       DEE
EEFMNNNO                      DEE
EEENNNNNNNNNNNNNNNNNNNNNNNNNNNEEE
