00000000000000000DEEEEEEEEEEEEEEE
000000000000000MNEEEEEEEEEEEEEEEE
000000000000000DEEEEEEEEEEEEEEEEE
000000000000000DEEEEEEEEEEEEEEEEE
000000000000000GHHHHHHHHHHHHHHHHH
000000000000000012222222222222222
000000000000000012222222222222222
000000000000000MNNNNN222222222222
00000000AC00ABBEEEEEEN22222222222
0000000AEF00DEEEEEEEEEN2222222222
KKKKKLBEEEBBEEEEEEEEEEEN222222222
EEEEEEEEEEEEEEEEEEEEEEEENNNNNNNNN
