                                                 DEEEEEEEEEEEEEEEEEEEEEEE
                                                 DEEEEEEEEEEEEEEEEEEEEEEE
                                                 DEEEEEEEEEEEEEEEEEEEEEEE
                                                 DEEEEEEEEEEEEEEEEEEEEEEE
                                                 DEEEEEEEEEEEEEEEEEEEEEEE
                                                 DEEEEEEEEEEEEEEEEEEEEEEE
                                                 DEEEEEEEEEEEEEEEEEEEEEEE
                                    ABBBBBBBB   4DEEEEEEEEEEEEEEEEEEEEEEE
                                    GHHHHHHDF    DEEEEEEEEEEEEEEEEEEEEEEE
                             ABBC    122222DF2222DEEEEEEEEEEEEEEEEEEEEEEE
              PQR           AEEEF    122222DF2222DEEEEEEEEEEEEEEEEEEEEEEE
JJJJJKLBBBBBBBBBBBBBBBBBBBBBEEEEEBBBBBBBBBBEF2222DEEEEEEEEEEEEEEEEEEEEEEE
MMMMMMMNOEEEEEEEEEEEEEEEEEEEEEEEEEEEEEEEEEEEF2222DEEEEEEEEEEEEEEEEEEEEEEE
MMMMMMMMMNOEEEEEEEEEEEEEEEEEEEEEEEEEEEEEEEEEF2222DEEEEEEEFHHHHHHHHHHHHHHE
MMMMMMMMMMMEEEEEEEEEEEEEEEEEEEEEEEEEEEEEEEEEF2222DEEEEEEEF22222222222222D
MMMMMMMMMMMEEEEEEEEEEEEEEEEEEEEEEEEEEEEEEEEEF2222DEEEEEEEF22222222222222D
MMMMMMMMMMMEEEEEEEEEEEEEEEEEEEEEEEEEEEEEEEEEF2222DEEEEEEEF22222222222222D
MMMMMMMMMMMEEEEEEEEEEEEEEEEEEEEEEEEEEEEEEEEEF2222GHHHHHHHI          9   D
MMMMMMMMMMMEEEEEEEEEEEEEEEEEEEEEEEEEEEEEEEEEF222222223             PR   D
MMMMMMMMMMMEEEEEEEEEEEEEEEEEEEEEEEEEEEEEEEEEF222222223            PQQR  D
MMMMMMMMMMMEEEEEEEEEEEEEEEEEEEEEEEEEEEEEEEEEEBBBBBBBBBBBBBBBBBBBBBBBBBBBB
