               FCDEDEDEDEDEDEDEDEDEDEDEDEDEDEDEDEDEDEDEDEDEDEDEDEDEDEDEDECFCFDEDEDEDEJFC
               CFJDEDEDEDEDEDEDEDEDEDEDE            DEDEDEDEDEDEDEDEDEDECFCFCJDEDEDEDECF
               FCDEDEDEDEDE7777777                                      FCFJFDEDEDEDEJFC
               CFJDEDEJ7777777777                  7777                  FDEDEDEDEDEDEJF
               FC1111617777777777                 781687                              JC
             DEJF161117777777777            GG    712317                               F
              111111617777787787            GG   II8618AB 45 AB AB 45 DEDEDE    7   7  C
              116111117DE77J77J7       HH        II7777AB 45 AB AB 45 DEJCJDE  787 787 F
          DEDEDEJGHIJ777777777777      HH              88 77 88 88 77   CFDEDE  7   7  C
         DEDEDEDEDEJ777777777777   CDEDEDEDE                            FJJDEDE787 787JF
        DEDEDEDEDEJC777777777777  JF       DE                           7777777 7   7  C
       DEDEDEDEDEDEF777777777777            DE                          7CJDEDE   9    F
      DEDEDEDEDEDEDE777777777777              77                        JFDEDEC   N    C
     DEDEDEDEDEDEDEC777777777777                7C                    DECCJDEJF  PQR   F
DEDEDEDEDEDEDEDEDEJFDEDEDEDEDEDEDEDEDEDEDEDEDEDEJFDEDEDEDEDEDEDEDEJDEDEJFFDEDEDEDEDEDEDE
EDEDEDEDEDEDEDEDEDEDEDEDEDEDEDEDEDEDEDEDEDEDEDEDEDEDEDEDEDEDEDEDEDEJDEDEDEJDEDEDEDEDEDED
