00000000000000000455
00000000000000000455
000000000000000AB555
00000000000000045555
00000000000000045555
00000000000000078888
00000000000000000000
00000000000000000000
000000000000000ABBBB
00000000130012255555
00000001560045555555
22222225552255555555
