00000000000000000455
000000000000000DE555
00000000000000045555
00000000000000045555
00000000000000078888
00000000000000000000
00000000000000000000
000000000000000DEEEE
00000000130012255555
00000001560045555555
BBBBBC25552255555555
55555555555555555555
