000000000000000004555555555555555
000000000000000DE5555555555555555
000000000000000455555555555555555
000000000000000455555555555555555
000000000000000788888888888888888
000000000000000000000000000000000
000000000000000000000000000000000
000000000000000DEEEEF000000000000
000000001300122555555F00000000000
0000000156004555555555F0000000000
BBBBBC25552255555555555F000000000
555555555555555555555555EEEEEEEEE
